50 30
023 023 023 023 006 017 017 017 017 017 017 017 017 017 017 017 017 017 017 017 007 023 023 023 023 023 023 023 023 023 023 023 023 023 023 006 017 017 017 017 017 017 017 017 017 017 017 007 023 023 
006 017 017 017 018 023 023 023 023 023 023 023 023 020 023 020 023 020 023 023 008 023 023 023 023 023 023 023 023 023 023 023 023 023 006 018 023 023 023 023 023 023 023 023 023 023 023 008 023 023 
010 023 020 023 020 023 023 023 023 023 023 023 023 020 023 020 023 020 023 023 008 023 023 023 023 023 023 023 023 023 023 006 017 017 018 023 023 023 023 023 023 023 023 023 023 023 023 008 023 023 
010 023 020 023 020 023 023 023 023 023 011 023 023 023 023 020 023 020 023 023 016 007 023 023 023 023 023 023 023 006 017 018 023 023 023 023 023 023 023 023 023 023 023 023 023 023 023 008 023 023 
010 023 020 023 023 023 023 023 000 001 001 002 023 023 023 020 023 023 023 023 023 016 017 017 017 017 017 017 017 018 023 023 023 023 023 023 023 023 023 023 023 023 012 001 013 023 023 008 023 023 
010 023 020 023 023 023 023 000 015 023 006 018 023 023 023 020 023 023 023 023 023 023 023 023 023 023 023 023 023 023 023 023 023 023 023 023 023 023 023 023 023 023 023 023 023 023 023 008 023 023 
010 023 023 023 023 023 000 015 023 006 018 023 023 023 023 023 023 023 023 023 023 023 023 023 023 023 023 023 023 023 023 023 023 023 023 023 023 023 023 023 023 023 023 023 023 023 023 008 023 023 
010 023 023 023 023 023 008 023 023 010 023 023 023 023 023 023 023 023 023 023 023 023 023 023 023 023 023 023 023 023 023 023 023 023 023 023 005 023 023 023 023 023 023 023 023 000 001 015 023 023 
014 002 023 023 023 023 016 007 023 010 023 023 023 023 023 023 023 023 000 001 002 023 023 023 023 023 023 023 023 023 023 023 023 023 023 023 023 023 023 023 023 023 023 023 023 008 023 023 023 023 
023 010 023 023 023 023 023 016 017 018 023 023 023 023 023 023 023 000 015 023 010 023 023 023 023 023 005 023 023 023 023 023 023 023 023 023 023 023 023 023 023 023 023 023 023 008 023 023 023 023 
023 010 023 023 023 023 023 023 023 023 023 023 023 023 023 023 023 008 023 023 010 023 023 023 023 023 023 023 023 023 023 000 002 023 023 023 023 023 023 023 023 023 000 001 001 015 023 023 023 023 
023 010 023 023 023 023 023 023 023 023 023 023 023 023 023 023 023 008 023 023 014 002 023 023 023 023 023 023 023 000 001 015 014 001 001 002 023 023 023 023 023 023 008 023 023 023 023 023 023 023
023 010 023 023 023 023 023 023 023 023 023 023 023 005 023 023 023 008 023 023 023 010 023 023 023 023 023 023 023 008 023 023 023 023 023 014 002 023 023 023 023 023 008 023 023 023 023 023 023 023
023 010 023 023 023 023 023 023 023 023 023 023 023 023 023 023 023 016 007 023 006 018 023 023 023 023 023 023 023 016 007 023 023 023 023 023 010 023 023 023 005 023 008 023 023 023 023 023 023 023 
006 018 023 023 023 023 023 023 023 023 023 023 023 023 023 023 023 023 016 017 018 023 023 023 023 023 023 023 023 023 016 007 023 023 023 006 018 023 023 023 023 023 016 007 023 023 023 023 023 023 
010 023 023 023 023 011 023 000 001 001 002 023 023 023 023 023 023 023 023 023 023 023 023 023 023 023 023 023 023 023 023 016 017 017 017 018 023 023 023 023 023 023 023 008 023 023 023 023 023 023 
010 023 023 023 023 000 001 015 023 023 014 002 023 023 023 023 023 023 023 023 023 023 023 023 023 023 023 023 023 023 023 023 023 023 023 023 023 023 005 023 023 023 023 016 017 017 017 017 017 007 
010 023 023 023 000 015 023 023 023 023 023 010 023 023 023 023 023 023 023 023 023 023 023 023 023 023 023 023 023 023 023 023 023 023 023 023 023 023 023 023 023 023 023 023 023 020 023 020 023 008 
010 023 023 023 008 023 023 023 023 023 023 010 023 023 005 023 023 023 023 023 023 023 023 023 023 023 023 023 023 023 023 023 023 023 023 023 023 023 023 023 023 023 023 023 023 020 023 020 023 008 
010 023 023 023 008 023 023 023 023 023 006 018 023 023 023 023 023 023 023 023 023 023 023 005 023 023 023 023 023 023 023 023 023 023 023 023 023 023 023 023 023 023 023 011 023 020 023 020 023 008 
010 023 023 023 016 017 017 017 017 017 018 023 023 023 023 023 023 023 023 023 023 023 023 023 023 023 023 023 023 023 023 023 023 023 023 023 023 023 023 000 001 001 001 002 023 023 023 020 023 008 
010 023 023 023 023 023 020 020 023 020 023 023 023 023 023 023 023 023 023 023 011 023 023 023 023 023 023 023 023 023 023 023 023 023 023 023 023 023 023 008 023 023 006 018 023 023 023 020 023 008 
010 023 023 023 023 023 020 020 023 023 023 023 023 023 023 023 023 023 023 000 001 001 001 002 023 023 023 023 023 023 023 023 023 023 023 023 023 023 023 008 006 017 018 023 023 023 023 020 023 008 
010 023 023 023 005 023 020 023 023 023 023 023 023 023 023 023 023 023 000 015 023 023 023 010 023 023 023 023 023 023 005 023 023 023 023 023 023 023 023 016 018 023 023 023 023 023 023 023 023 008 
010 023 023 023 023 023 020 023 023 023 005 023 023 023 023 023 023 023 008 023 023 023 006 018 023 023 023 023 023 023 023 023 023 023 023 023 023 023 023 023 023 023 023 023 023 023 023 023 023 008 
014 001 001 002 023 023 023 023 023 023 023 023 023 023 023 023 023 023 016 007 023 006 018 023 023 023 023 023 023 023 023 023 023 023 023 023 000 001 001 001 001 001 001 001 002 023 023 023 023 008 
023 023 023 010 023 023 023 023 023 023 023 023 023 023 023 023 023 023 023 016 017 018 023 023 023 023 023 023 023 023 023 023 023 023 023 000 015 006 017 017 017 017 017 017 018 023 023 023 023 008 
023 023 023 010 023 023 023 023 023 023 023 023 023 023 023 023 023 023 023 023 023 023 023 023 023 023 023 023 023 023 023 023 023 023 000 015 023 010 023 023 023 023 023 023 023 023 023 011 000 015 
023 023 023 014 001 001 001 001 001 001 001 001 002 023 023 023 023 023 023 023 023 023 023 023 023 023 023 023 023 023 023 023 023 000 015 023 023 010 023 023 023 023 023 023 023 023 023 000 015 023 
023 023 023 023 023 023 023 023 023 023 023 023 014 001 001 001 001 001 001 001 001 001 001 001 001 001 001 001 001 001 001 001 001 015 023 023 023 014 001 001 001 001 001 001 001 001 001 015 023 023 
