20 20
023 023 023 023 023 023 023 023 023 023 023 023 023 023 023 023 023 023 023 023
023 023 023 023 023 023 023 023 023 023 023 023 023 023 023 023 023 023 023 023
023 023 006 017 017 017 007 023 023 023 023 023 023 023 023 023 023 023 023 023
023 023 010 023 023 023 008 023 023 023 023 023 023 023 006 017 017 017 007 023
023 023 010 023 003 023 008 023 023 023 023 023 023 006 018 023 023 023 008 023
023 023 014 001 001 001 015 023 023 023 023 023 023 010 023 023 011 023 008 023
023 023 023 023 023 023 023 023 023 023 023 023 023 014 001 001 001 001 015 023
023 023 023 023 023 023 023 023 023 023 023 023 023 023 023 023 023 023 023 023
023 023 023 023 023 023 006 017 017 017 017 017 007 006 017 017 017 017 007 023
023 006 017 007 023 023 010 023 020 023 020 023 016 018 022 022 022 022 008 023
023 010 020 008 023 023 010 023 020 023 023 023 023 023 023 023 023 022 008 023
023 010 020 008 023 023 010 023 023 023 023 023 023 023 023 023 023 022 008 023
023 010 020 008 023 023 010 023 023 023 023 025 023 023 023 019 023 022 008 023
023 014 001 015 023 023 014 001 001 001 001 001 001 002 022 022 022 022 008 023
023 023 023 023 023 023 023 023 023 023 023 023 023 014 001 001 001 001 015 023
023 023 023 023 006 017 017 007 023 023 023 023 023 023 023 023 023 023 023 023
023 023 023 023 010 020 023 008 023 023 023 023 023 023 023 006 017 007 023 023
023 023 023 023 010 023 011 008 023 023 023 023 023 023 023 010 003 008 023 023
023 023 023 023 014 001 001 015 023 023 023 023 023 023 023 014 001 015 023 023
023 023 023 023 023 023 023 023 023 023 023 023 023 023 023 023 023 023 023 023
