20 16
023 023 023 023 023 023 023 023 023 023 023 023 023 023 023 023 023 023 023 023 
023 023 023 023 023 023 023 023 023 023 023 023 023 023 023 023 023 023 023 023 
023 023 023 023 023 023 023 023 023 023 023 023 023 023 023 023 023 023 023 023 
023 023 023 023 023 023 023 023 023 023 023 023 023 023 023 023 023 023 023 023 
023 023 023 023 023 023 023 023 023 023 023 023 023 023 023 023 023 023 023 023 
023 023 023 023 023 023 023 023 023 023 023 023 023 023 023 023 023 023 023 023 
023 023 023 023 023 023 023 023 023 023 023 023 023 023 023 023 023 023 023 023 
023 023 023 006 017 017 017 017 017 017 017 017 017 017 007 023 023 023 023 023 
023 023 023 010 023 023 020 023 023 020 023 023 023 023 016 007 023 023 023 023
023 023 023 010 023 023 020 023 023 020 023 023 023 023 023 008 023 023 023 023
023 023 023 010 023 023 020 023 023 023 023 023 023 023 023 016 017 007 023 023
023 023 023 010 023 023 020 023 023 023 023 023 023 023 023 023 023 008 023 023
023 023 023 010 023 023 023 023 023 023 023 023 023 023 023 023 023 008 023 023 
023 023 023 010 023 023 023 023 023 023 023 023 000 001 001 001 001 015 023 023 
023 023 023 010 023 023 023 023 023 023 023 023 008 023 023 023 023 023 023 023 
023 023 023 014 001 001 001 001 001 001 001 001 015 023 023 023 023 023 023 023 
