20 16
023 023 023 023 023 023 023 023 023 023 023 023 023 023 023 023 023 023 023 023 
023 023 023 023 006 017 017 017 017 017 017 017 007 023 023 023 023 023 023 023 
023 023 023 006 018 023 023 023 023 023 023 023 016 007 023 023 023 023 023 023 
023 023 023 010 023 023 023 023 023 023 023 023 023 016 007 023 023 023 023 023 
023 006 017 018 023 023 023 023 023 023 023 023 023 023 016 007 023 023 023 023 
006 018 023 023 023 023 023 023 023 023 023 023 023 023 023 016 017 017 007 023 
010 023 023 023 023 023 023 023 023 023 023 023 023 023 023 023 023 023 016 007 
010 023 023 023 023 023 023 023 023 023 023 023 023 023 023 023 023 023 023 008 
010 013 023 023 023 023 023 023 023 023 023 023 023 023 023 023 023 023 023 008
010 023 023 023 023 023 023 023 023 023 023 023 023 023 023 023 023 023 023 008
010 023 023 023 023 023 023 023 023 023 023 023 023 023 023 023 023 023 012 008
010 023 023 023 023 023 023 023 023 023 023 023 023 023 023 023 023 023 023 008 
014 001 001 001 001 001 002 023 023 023 023 023 023 023 023 023 023 023 023 008 
023 023 023 023 023 023 014 013 023 023 023 023 023 012 001 001 001 001 001 015 
023 023 023 023 023 023 023 023 023 023 023 023 023 023 023 023 023 023 023 023 
023 023 023 023 023 023 023 023 023 023 023 023 023 023 023 023 023 023 023 023 
