20 42
023 023 023 023 023 023 023 023 023 023 023 023 023 023 023 023 023 023 023 023
023 023 023 023 023 023 023 023 023 023 023 023 023 023 023 023 023 023 023 023
023 023 023 023 023 006 017 017 017 017 017 017 017 017 007 023 023 023 023 023
023 023 023 023 023 010 023 020 023 023 020 023 020 023 008 023 023 023 023 023
023 023 023 023 023 010 023 020 023 023 020 023 020 023 008 023 023 023 023 023
023 023 023 023 023 010 023 023 023 023 020 023 020 023 008 023 023 023 023 023
023 023 023 023 023 010 023 023 023 023 020 023 023 023 008 023 023 023 023 023
023 023 023 023 023 010 023 023 019 023 020 023 023 023 008 023 023 023 023 023
023 023 023 023 023 010 023 023 023 023 023 023 023 023 008 023 023 023 023 023
023 023 023 023 023 010 023 023 023 023 023 019 023 023 008 023 023 023 023 023
023 023 023 023 023 010 023 019 023 023 023 023 023 023 008 023 023 023 023 023
023 023 023 023 023 010 023 023 023 023 019 023 023 023 008 023 023 023 023 023
023 023 023 023 023 010 023 023 023 023 023 023 023 023 008 023 023 023 023 023
023 023 023 023 023 010 023 023 019 023 023 023 019 023 008 023 023 023 023 023
023 023 023 023 023 010 023 023 023 023 023 023 023 023 008 023 023 023 023 023
023 023 023 023 023 010 023 023 023 023 019 023 023 023 008 023 023 023 023 023
023 023 023 023 023 010 023 023 023 023 023 023 023 023 008 023 023 023 023 023
023 023 023 023 023 010 023 019 023 023 023 019 023 023 008 023 023 023 023 023
023 023 023 023 023 010 023 023 023 023 023 023 023 023 008 023 023 023 023 023
023 023 023 023 023 010 023 023 023 019 023 023 023 023 008 023 023 023 023 023
023 023 023 023 023 010 023 023 023 023 023 023 023 023 008 023 023 023 023 023
023 023 023 023 023 010 023 023 023 023 023 019 023 023 008 023 023 023 023 023
023 023 023 023 023 010 023 023 023 023 023 023 023 023 008 023 006 017 017 007
023 023 023 023 023 010 023 023 023 023 023 023 023 023 008 023 010 023 020 008
023 023 023 023 023 010 023 019 023 023 023 023 019 023 008 023 010 023 020 008
023 023 023 023 023 010 023 023 023 023 019 023 023 023 008 023 010 005 020 008
023 023 023 023 023 010 023 023 023 023 023 023 023 023 016 007 010 023 020 008
023 023 023 023 023 010 022 022 000 001 001 001 002 023 023 008 010 023 023 008
023 023 023 023 023 010 023 023 008 006 017 007 010 023 023 008 010 005 023 008
023 023 023 023 023 010 023 023 008 010 020 008 010 023 023 008 010 023 023 008
023 023 023 023 023 010 023 023 008 010 020 016 018 004 023 016 018 023 005 008
023 023 023 023 023 010 023 023 008 010 023 020 023 023 023 023 023 023 023 008
023 023 023 023 023 010 023 023 008 014 002 023 011 023 011 023 023 011 023 008
023 023 023 023 023 010 023 023 008 023 014 001 001 001 013 023 023 012 001 015
023 023 023 023 023 010 023 023 008 023 023 023 023 023 023 023 023 023 023 023
023 023 023 023 023 010 023 023 016 017 017 017 017 017 017 007 023 023 023 023
023 023 023 023 023 010 023 023 020 023 020 023 020 023 020 008 023 023 023 023
023 023 023 023 023 010 023 023 020 023 020 023 020 023 020 008 023 023 023 023
023 023 023 023 023 010 023 023 020 023 023 023 020 023 020 008 023 023 023 023
023 023 023 023 023 010 023 023 023 023 023 023 020 023 023 008 023 023 023 023
023 023 023 023 023 010 023 023 023 023 023 023 023 023 023 008 023 023 023 023
023 023 023 023 023 014 001 001 001 001 001 001 001 001 001 015 023 023 023 023
