20 40
023 006 017 017 017 017 017 007 023 023 023 023 023 023 023 023 023 023 023 023
023 010 023 023 023 023 023 016 017 017 017 017 017 017 017 017 017 017 007 023
023 010 023 023 023 023 023 023 023 023 023 020 023 020 023 020 023 023 008 023
023 010 023 023 023 023 023 023 023 023 023 020 023 020 023 020 023 023 008 023
023 014 001 001 001 002 023 023 023 023 023 020 023 023 023 020 023 023 008 023
023 023 023 023 023 010 023 023 023 023 023 020 023 023 023 020 023 023 008 023
023 023 023 023 023 010 023 023 023 019 023 023 023 023 023 023 023 023 008 023
023 023 023 023 023 010 023 023 023 023 023 023 023 023 023 023 023 000 015 023
023 023 023 006 017 018 023 023 023 023 023 023 023 023 023 023 000 015 023 023
023 023 023 010 023 020 023 023 023 023 023 023 023 019 023 023 008 023 023 023
023 023 023 010 023 020 023 023 023 023 023 023 023 023 023 023 008 023 023 023
023 023 023 010 023 020 023 023 023 005 023 023 023 023 023 023 008 023 023 023
023 006 017 018 023 023 023 023 023 023 023 023 023 023 023 023 008 023 023 023
023 010 023 023 023 023 023 023 023 023 023 023 023 023 023 000 015 023 023 023
023 010 023 023 023 023 023 023 023 023 005 023 023 023 023 008 023 023 023 023
023 010 023 023 023 023 023 023 023 023 023 023 023 023 023 008 023 023 023 023
023 010 011 023 023 019 023 023 023 023 023 023 023 023 023 008 023 023 023 023
023 014 002 023 023 023 023 023 023 023 023 023 023 023 023 016 007 023 023 023
023 023 010 023 023 023 023 023 023 023 019 023 023 023 023 023 016 017 017 007
023 023 014 001 001 002 023 023 023 023 023 023 023 023 023 023 023 023 023 008
023 023 023 023 023 010 023 023 023 023 023 023 023 023 023 019 023 023 023 008
023 023 023 023 023 010 023 023 023 023 023 023 023 023 023 023 023 023 023 008
023 023 023 023 023 010 023 023 023 023 023 023 023 019 023 023 023 023 023 008
023 023 023 023 023 010 023 023 023 023 023 023 023 023 023 023 023 023 023 008
023 023 023 006 017 018 023 023 023 023 023 019 023 023 023 023 023 023 023 008
023 023 006 018 023 023 023 023 023 023 023 023 023 011 023 023 023 023 023 008
023 023 010 023 023 023 023 023 023 023 000 001 001 001 002 023 023 023 023 008
023 006 018 023 023 023 023 023 023 023 008 023 023 023 010 023 023 023 023 008
023 010 023 023 023 023 023 023 005 023 008 023 006 017 018 023 023 023 023 008
023 010 023 023 023 023 023 023 023 023 016 017 018 023 020 023 023 023 023 008
023 010 023 023 023 023 023 023 023 023 020 023 020 023 020 023 023 023 023 008
023 010 023 023 023 023 023 005 023 023 020 023 020 023 023 023 023 011 023 008
023 010 023 023 023 023 023 023 023 023 023 023 020 023 023 023 023 000 001 015
023 010 023 023 023 023 023 023 023 023 023 023 020 023 023 023 023 008 023 023
023 010 023 023 023 023 023 023 012 013 023 023 023 023 023 023 023 008 023 023
023 010 023 023 023 023 023 023 023 023 023 023 023 023 023 023 000 015 023 023
006 018 023 023 023 023 023 023 023 023 023 023 023 023 023 023 008 023 023 023
010 023 023 023 023 023 023 023 023 000 001 002 023 023 023 023 016 017 017 017
010 023 023 023 023 023 023 023 023 008 023 010 023 023 023 023 023 023 023 023
010 023 023 023 023 023 023 023 023 008 023 010 023 023 023 023 023 023 023 023
