47 47
006 017 017 017 017 017 017 007 023 023 023 023 023 023 023 023 023 023 023 023 023 023 023 023 023 023 023 023 023 023 023 023 023 023 023 023 023 023 023 023 023 023 023 023 023 023 023
010 023 023 023 023 023 023 016 007 023 023 023 023 023 023 023 023 023 023 023 005 022 022 022 005 022 022 022 005 023 023 023 023 023 023 023 023 023 023 023 023 023 023 023 023 023 023
014 002 023 023 023 023 023 023 008 023 023 023 023 023 023 023 005 022 022 005 006 017 017 007 022 006 017 017 007 022 022 022 005 023 023 023 023 023 023 023 023 023 023 023 023 023 023
023 014 001 001 001 001 002 023 016 007 023 023 023 023 005 022 022 006 017 017 018 023 023 008 005 010 023 023 016 017 017 007 022 022 005 023 023 023 023 023 023 023 023 023 023 023 023
023 023 023 023 023 023 010 023 023 008 023 023 005 022 023 023 006 018 023 023 023 023 023 008 022 010 023 023 023 023 023 016 017 017 007 022 005 023 023 023 023 023 023 023 023 023 023
023 023 023 023 023 023 010 023 023 016 017 005 022 023 023 023 010 023 023 000 001 002 023 008 005 010 023 023 023 023 023 023 023 023 016 007 022 005 023 023 023 023 023 023 023 023 023
023 023 023 023 023 023 014 002 023 023 023 016 017 007 023 023 010 023 000 015 022 010 023 008 022 014 001 001 002 023 023 023 023 023 023 016 007 023 022 023 023 023 023 023 023 023 023
023 023 023 023 023 023 023 014 002 023 023 023 023 016 017 007 010 023 016 007 005 010 023 008 005 023 023 023 010 023 023 023 023 023 023 023 008 023 023 022 023 023 023 023 023 023 023
023 023 023 023 023 023 023 023 005 001 001 002 023 023 023 016 018 023 023 008 006 018 023 008 022 023 023 023 010 023 023 023 023 023 005 023 008 023 023 023 022 023 023 023 023 023 023
023 023 023 023 023 023 023 022 017 017 007 010 023 023 023 023 023 023 000 015 010 023 023 008 005 023 023 023 010 023 023 023 023 023 023 023 008 023 023 023 023 022 023 023 023 023 023
023 023 023 023 023 023 005 010 023 023 008 010 023 000 001 002 023 023 016 017 018 023 023 008 022 023 023 023 010 023 023 023 023 023 023 023 008 023 023 023 023 023 005 023 023 023 023
023 023 023 023 023 005 022 010 023 000 015 010 023 008 022 014 002 023 023 023 023 023 000 015 005 023 023 023 010 023 023 023 005 023 023 023 008 023 023 023 023 023 022 005 023 023 023
023 023 023 023 023 022 017 018 023 016 017 018 023 008 005 022 010 023 023 023 023 023 008 023 022 023 006 017 018 023 023 023 023 023 023 023 008 023 023 023 023 023 023 022 023 023 023
023 023 023 023 005 010 023 023 023 023 023 023 023 008 022 005 010 023 000 001 002 023 008 023 005 023 010 023 023 023 023 023 023 023 005 023 016 017 017 017 017 007 023 023 005 023 023
023 023 023 023 022 010 023 000 001 001 002 023 023 016 007 022 010 023 008 009 010 023 008 023 022 023 010 023 023 023 023 023 023 023 023 023 023 023 023 023 023 016 007 023 022 023 023
023 023 023 005 022 010 023 016 007 022 014 002 023 023 008 005 010 023 016 007 010 023 008 023 005 023 014 002 023 023 023 023 023 023 023 023 023 023 023 023 023 023 016 007 022 005 023
023 023 023 022 023 010 023 023 008 005 022 010 023 023 016 017 018 023 023 008 010 023 008 023 022 023 023 010 023 023 023 023 023 023 005 023 023 023 023 023 023 023 023 008 023 022 023
023 023 023 022 006 018 023 023 016 007 005 010 023 023 023 023 023 023 023 016 018 023 008 023 005 023 023 014 002 023 023 023 023 023 023 023 023 023 023 000 002 023 023 008 023 022 023
023 023 023 005 010 023 023 023 023 008 022 010 023 023 000 001 002 023 023 023 023 023 008 023 022 023 023 023 014 001 001 001 001 002 023 023 023 023 000 015 010 005 023 008 023 022 023
023 023 005 023 010 023 023 023 023 008 005 010 023 000 015 009 010 023 023 023 023 000 022 022 005 022 022 005 017 017 017 007 005 010 023 023 023 000 015 006 018 023 023 008 023 023 005
023 023 022 023 014 002 023 023 023 008 022 010 023 016 017 017 018 023 000 001 001 005 006 017 017 017 017 018 023 023 023 008 022 010 023 023 023 008 006 018 023 023 023 008 023 023 022
023 023 022 023 023 014 002 023 000 015 005 010 023 023 023 023 023 023 008 023 022 006 018 020 023 020 023 023 023 023 023 008 005 010 023 023 023 008 010 023 023 023 000 015 023 023 022
023 023 022 023 023 023 010 023 008 005 022 014 001 001 001 001 001 001 015 023 022 010 023 020 023 020 023 023 023 023 000 015 022 014 001 001 001 015 010 023 023 023 008 023 023 023 022
023 023 005 022 005 022 005 023 005 022 005 022 005 022 005 022 005 022 005 022 005 010 023 020 023 023 023 000 005 022 005 022 005 022 005 022 005 022 005 023 023 023 005 022 005 022 005
023 023 022 023 023 023 010 023 008 006 017 017 017 017 017 017 017 017 017 007 022 010 023 023 023 023 023 008 022 006 017 017 017 017 007 023 023 023 014 002 023 023 016 017 007 023 022
023 023 022 023 023 023 010 023 008 010 023 023 023 023 023 023 023 023 023 016 022 014 002 023 023 003 000 015 022 010 023 023 023 023 016 017 017 007 009 014 002 023 023 023 008 023 022
023 023 022 023 023 023 010 023 008 010 023 023 023 000 001 002 023 023 023 023 016 005 014 001 001 001 015 005 023 010 023 000 002 023 023 023 023 016 017 017 007 002 023 023 008 023 022
023 023 005 023 006 017 018 023 008 014 002 023 023 016 007 014 002 023 023 023 023 016 022 022 005 022 022 023 023 010 023 008 010 023 023 023 023 023 023 023 008 010 019 023 008 023 005
023 023 023 022 010 023 023 023 016 007 014 002 023 023 016 007 014 002 023 023 023 023 016 007 022 023 023 023 023 010 023 008 010 023 000 001 002 023 023 023 008 010 023 023 008 022 023
023 023 023 022 010 023 023 023 023 016 007 014 002 023 023 016 007 010 023 023 023 023 023 008 005 006 017 017 017 018 023 008 010 023 016 017 018 023 023 023 016 018 023 023 008 022 023
023 023 023 022 014 002 023 023 023 023 016 007 014 002 023 023 008 010 023 023 000 002 023 008 022 010 023 023 023 023 023 016 018 023 023 023 023 023 019 023 023 023 023 000 015 022 023
023 023 023 005 022 010 023 023 023 023 023 016 007 014 002 023 008 010 005 023 008 010 023 008 005 010 023 023 023 023 023 023 023 023 023 023 023 023 023 023 023 023 023 008 022 005 023
023 023 023 023 022 014 002 023 023 023 023 023 016 007 014 001 015 010 023 023 008 010 023 008 022 010 023 023 000 001 001 001 001 001 001 001 002 023 023 023 023 023 005 008 022 023 023
023 023 023 023 005 023 014 002 023 023 023 023 023 016 007 005 022 010 023 023 008 010 023 008 005 010 023 005 008 023 023 023 023 023 023 023 010 023 023 023 023 000 001 015 005 023 023
023 023 023 023 023 022 023 014 002 023 023 023 023 023 016 007 005 010 005 023 008 010 023 008 022 010 023 023 008 023 023 023 023 023 023 023 014 001 001 002 023 008 023 022 023 023 023
023 023 023 023 023 005 022 023 014 002 023 023 023 023 023 008 022 010 023 023 008 010 023 008 005 010 023 023 016 017 017 017 017 017 017 007 023 023 023 014 001 015 022 005 023 023 023
023 023 023 023 023 023 005 023 023 014 002 023 023 023 023 016 007 010 023 023 008 010 023 008 022 010 019 023 023 023 023 023 023 023 023 016 007 023 006 017 007 023 005 023 023 023 023
023 023 023 023 023 023 023 022 023 023 014 002 023 023 023 023 008 010 005 023 008 010 023 008 005 010 023 023 023 023 023 023 023 023 023 023 016 007 010 011 008 022 023 023 023 023 023
023 023 023 023 023 023 023 023 022 023 023 014 002 023 023 023 016 018 023 023 008 010 023 008 022 014 001 001 001 001 001 001 001 002 023 023 023 008 014 001 022 023 023 023 023 023 023
023 023 023 023 023 023 023 023 023 022 023 023 014 002 023 023 023 023 023 023 008 010 023 016 005 017 017 017 017 017 017 017 017 018 023 023 023 008 023 022 023 023 023 023 023 023 023
023 023 023 023 023 023 023 023 023 023 022 023 023 010 023 023 023 023 005 023 008 010 023 023 023 023 023 023 023 023 023 023 023 023 023 000 001 015 022 023 023 023 023 023 023 023 023
023 023 023 023 023 023 023 023 023 023 023 005 022 014 002 023 023 023 023 023 008 010 023 023 023 023 023 023 023 023 023 023 023 023 000 015 022 005 023 023 023 023 023 023 023 023 023
023 023 023 023 023 023 023 023 023 023 023 023 005 022 014 001 001 002 023 023 008 010 023 023 023 023 000 001 001 001 001 001 001 001 015 022 005 023 023 023 023 023 023 023 023 023 023
023 023 023 023 023 023 023 023 023 023 023 023 023 023 005 022 022 014 001 001 015 010 023 023 023 000 015 023 023 023 023 023 022 022 005 023 023 023 023 023 023 023 023 023 023 023 023
023 023 023 023 023 023 023 023 023 023 023 023 023 023 023 023 005 022 022 022 023 014 001 001 001 015 023 023 023 022 022 022 005 023 023 023 023 023 023 023 023 023 023 023 023 023 023
023 023 023 023 023 023 023 023 023 023 023 023 023 023 023 023 023 023 023 023 005 022 022 022 005 022 022 022 005 023 023 023 023 023 023 023 023 023 023 023 023 023 023 023 023 023 023
023 023 023 023 023 023 023 023 023 023 023 023 023 023 023 023 023 023 023 023 023 023 023 023 023 023 023 023 023 023 023 023 023 023 023 023 023 023 023 023 023 023 023 023 023 023 023
